8 8
02 02 02 02 02 02 02 02
02 67 67 67 67 67 67 02
02 67 67 67 67 48 67 02
02 67 67 67 67 67 67 02
02 67 03 67 03 03 67 02
02 67 67 67 03 67 67 02
02 67 05 67 67 67 67 02
02 02 02 02 02 02 02 02
