8 8
02 02 02 02 02 02 02 02
02 43 43 43 50 50 50 02
02 43 43 43 50 15 50 02
02 43 43 43 50 50 50 02
02 43 03 43 16 16 43 02
02 43 43 43 16 43 43 02
02 43 05 43 43 43 43 02
02 02 02 02 02 02 02 02
